11111111
1P0011E1
100C0011
11111111