1111111111
1C000C0011
1P00110001
100C00C0E1
1111111111
