1111111111111111111111111111
10000C00100000000000000C0001
1P00110000111100000000000001
1000001000000100000000000001
1111111111000011111111111111
1C00000C00000000000000000001
10001000000C00000000000000E1
1111111111111111111111111111